


G                           G
G                           G
G                           G
G                           G
G                           G
G                           G
G                           G
G   ?                       G
G                           G
GGGGGGGGGGG   GGGGGGGGGGGGGGG
G                           G
G     KKKK                  G
G              KKKKKK       G
G        KKK                G
G                           G
G                           G
G    KKKKK                  G
G                           G
G             KKKKKK        G
G       K                   G
G                           G
G    KKKK   KKK             G
G     KKKK   KKK            G
G     KKKK  KKKK     KKKKKK G
G     KKKK  KKKK            G
G     KKKK  KKKK            G
G                           G
G                           G
G                           G
G          KKK              G
G         K                 G
G  KK                       G
G    KK          KKKKKK     G
G                           G
G     KK  KKK   GGGGGGGGGGGGG
G               G           G
G               G           G
G               G           G
G   ?           M      !    G
GGGGGGGGGGGGGGGGGGKKKGGGGKKKG