G
G
G
G
G
G
G             G
G  ?        Q G
G        GK   G
GGGGGGGGGGG K GGGGGGGGGGGGGGG
G                           G
G           q               G
G                           G
G        GGGGKKKKKGGGGGGGGGGG
G       K                   G
G     GG  K          M      G
G         K        M M  GG  GGGGGG
G G      G       M M M      M  ! G
GGGG  GGG      GKKKKKKKKKKKGGGGGGG
G                           G
G       G     G             G
G       G  G                G
G       G    G  G   G       G
G                 G         G
G    ?       G  G           G
G          G                G
GGGGGGGGGGGGKKKKKKKKKKKKKGGGG